{
    "spawn": {
        "width": 20,
        "height": 14,
        "spawnPoint": {
            "x": 100,
            "y": 250
        },
        "back_layer": [
            [6, 7, 7, 7, 7, 7, 7, 7, 7, 7, 7, 7, 7, 7, 7, 7, 7, 7, 7, 8],
            [14, 15, 15, 15, 15, 15, 15, 15, 15, 15, 15, 15, 15, 15, 15, 15, 15, 15, 15, 16],
            [14, 15, 15, 15, 15, 15, 15, 15, 15, 15, 15, 15, 15, 15, 15, 15, 15, 15, 15, 16],
            [14, 15, 15, 15, 15, 15, 15, 15, 15, 15, 15, 15, 15, 15, 15, 15, 15, 15, 15, 16],
            [14, 15, 15, 15, 15, 15, 15, 15, 15, 15, 15, 15, 15, 15, 15, 15, 15, 15, 15, 16],
            [14, 15, 15, 15, 15, 15, 15, 15, 15, 15, 15, 15, 15, 15, 15, 15, 15, 15, 15, 16],
            [14, 15, 15, 15, 15, 15, 15, 15, 15, 15, 15, 15, 15, 15, 15, 15, 15, 15, 15, 16],
            [14, 15, 15, 15, 15, 15, 15, 15, 15, 15, 15, 15, 15, 15, 15, 15, 15, 15, 15, 16],
            [14, 15, 15, 15, 15, 15, 15, 15, 15, 15, 15, 15, 15, 15, 15, 15, 15, 15, 15, 16],
            [14, 15, 15, 15, 15, 15, 15, 15, 15, 15, 15, 15, 15, 15, 15, 15, 15, 15, 15, 16],
            [14, 15, 15, 15, 15, 15, 15, 15, 15, 15, 15, 15, 15, 15, 15, 15, 15, 15, 15, 16],
            [14, 15, 15, 15, 15, 15, 15, 15, 15, 15, 15, 15, 15, 15, 15, 15, 15, 15, 15, 16],
            [14, 15, 15, 15, 15, 15, 15, 15, 15, 15, 15, 15, 15, 15, 15, 15, 15, 15, 15, 16],
            [22, 23, 23, 23, 23, 23, 23, 23, 23, 23, 23, 23, 23, 23, 23, 23, 23, 23, 23, 24]
        ]
    },
    "spawn1": {
        "width": 20,
        "height": 14,
        "spawnPoint": {
            "x": 250,
            "y": 100
        },
        "back_layer": [
            [54, 55, 55, 55, 55, 55, 55, 55, 55, 55, 55, 55, 55, 55, 55, 55, 55, 55, 55, 56],
            [62, 63, 63, 63, 63, 63, 63, 63, 63, 63, 63, 63, 63, 63, 63, 63, 63, 63, 63, 64],
            [62, 63, 63, 63, 63, 63, 63, 63, 63, 63, 63, 63, 63, 63, 63, 63, 63, 63, 63, 64],
            [62, 63, 63, 63, 63, 63, 63, 63, 63, 63, 63, 63, 63, 63, 63, 63, 63, 63, 63, 64],
            [62, 63, 63, 63, 63, 63, 63, 63, 63, 63, 63, 63, 63, 63, 63, 63, 63, 63, 63, 64],
            [62, 63, 63, 63, 63, 63, 63, 63, 63, 63, 63, 63, 63, 63, 63, 63, 63, 63, 63, 64],
            [62, 63, 63, 63, 63, 63, 63, 63, 63, 63, 63, 63, 63, 63, 63, 63, 63, 63, 63, 64],
            [62, 63, 63, 63, 63, 63, 63, 63, 63, 63, 63, 63, 63, 63, 63, 63, 63, 63, 63, 64],
            [62, 63, 63, 63, 63, 63, 63, 63, 63, 63, 63, 63, 63, 63, 63, 63, 63, 63, 63, 64],
            [62, 63, 63, 63, 63, 63, 63, 63, 63, 63, 63, 63, 63, 63, 63, 63, 63, 63, 63, 64],
            [62, 63, 63, 63, 63, 63, 63, 63, 63, 63, 63, 63, 63, 63, 63, 63, 63, 63, 63, 64],
            [62, 63, 63, 63, 63, 63, 63, 63, 63, 63, 63, 63, 63, 63, 63, 63, 63, 63, 63, 64],
            [62, 63, 63, 63, 63, 63, 63, 63, 63, 63, 63, 63, 63, 63, 63, 63, 63, 63, 63, 64],
            [70, 71, 71, 71, 71, 71, 71, 71, 71, 71, 71, 71, 71, 71, 71, 71, 71, 71, 71, 72]
        ]
    },
    "spawn2": {
        "width": 14,
        "height": 20,
        "spawnPoint": {
            "x": 250,
            "y": 250
        },
        "back_layer": [
            [102, 103, 103, 103, 103, 103, 103, 103, 103, 103, 103, 103, 103, 104],
            [110, 111, 111, 111, 111, 111, 111, 111, 111, 111, 111, 111, 111, 112],
            [110, 111, 111, 111, 111, 111, 111, 111, 111, 111, 111, 111, 111, 112],
            [110, 111, 111, 111, 111, 111, 111, 111, 111, 111, 111, 111, 111, 112],
            [110, 111, 111, 111, 111, 111, 111, 111, 111, 111, 111, 111, 111, 112],
            [110, 111, 111, 111, 111, 111, 111, 111, 111, 111, 111, 111, 111, 112],
            [110, 111, 111, 111, 111, 111, 111, 111, 111, 111, 111, 111, 111, 112],
            [110, 111, 111, 111, 111, 111, 111, 111, 111, 111, 111, 111, 111, 112],
            [110, 111, 111, 111, 111, 111, 111, 111, 111, 111, 111, 111, 111, 112],
            [110, 111, 111, 111, 111, 111, 111, 111, 111, 111, 111, 111, 111, 112],
            [110, 111, 111, 111, 111, 111, 111, 111, 111, 111, 111, 111, 111, 112],
            [110, 111, 111, 111, 111, 111, 111, 111, 111, 111, 111, 111, 111, 112],
            [110, 111, 111, 111, 111, 111, 111, 111, 111, 111, 111, 111, 111, 112],
            [110, 111, 111, 111, 111, 111, 111, 111, 111, 111, 111, 111, 111, 112],
            [110, 111, 111, 111, 111, 111, 111, 111, 111, 111, 111, 111, 111, 112],
            [110, 111, 111, 111, 111, 111, 111, 111, 111, 111, 111, 111, 111, 112],
            [110, 111, 111, 111, 111, 111, 111, 111, 111, 111, 111, 111, 111, 112],
            [110, 111, 111, 111, 111, 111, 111, 111, 111, 111, 111, 111, 111, 112],
            [110, 111, 111, 111, 111, 111, 111, 111, 111, 111, 111, 111, 111, 112],
            [118, 119, 119, 119, 119, 119, 119, 119, 119, 119, 119, 119, 119, 120]
        ]
    }
}